omg	oh my god
idk	I don't know
idek	I don't even know
omfg	oh my fucking god
wtf	what the fuck
smh	shaking my head
ily	I love you
ilysm	I love you so much
tbh	to be honest
idc	I don't care
stfu	shut the fuck up
btw	by the way
ik	I know
idgaf	I don't give a fuck
jk	just kidding
hmu	hit me up
bff	best friend
nvm	never mind
ffs	for fucks sake
oomf	one of my friends